NO 			./maps/textures/texture5.png
SO 	./maps/textures/texture2.png
WE        ./maps/textures/texture3.png
EA               ./maps/textures/texture1.png
        	       
F 			  1,0,1
C 255,255,0

1111111
1010011
1001001
10N0001
1111111
