NO ./maps/textures/basic.png
SO ./maps/textures/basic.png
WE ./maps/textures/basic.png
EA ./maps/textures/basic.png

F 0,0,255
C 200,200,0

              1111111111111111111111111111
              10000000000000000000000000011
1111111111111110S00000000000011000000000011
100000000000000001000000000011111111111111
10000000000000000010000000001
10000001000000000000000000001
10000000000000000000000000001
10001000000000000000000000001
10001100000000000000000000001
10000000000000001000000000001
10000000000000000000100000001
11111111111111111111111111111
