NO ./maps/textures/basic.png
SO ./maps/textures/basic.png
WE ./maps/textures/basic.png
EA ./maps/textures/basic.png

F 225,255,255
C 255,0,0

11111111111111111111111111111
100000000000011
100000N0000000111111111111111
11111111111111111111111111111
