NO ./maps/textures/basic.png
SO ./maps/textures/basic.png
WE ./maps/textures/basic.png
EA ./maps/textures/basic.png

F 225,255,255
C 255,0,0

11111111111111111111111111111
10000000000000000000000000011
10000000000000011000000000011
10000000000000000000000000001
10000000000000000010000000001
10000001000000000000000000001
10000000000000000000000000001
100010000000000N0000000000001
10001100000000000000000000001
10000000000000001000000000001
10000000000000000000100000001
11111111111111111111111111111
